2019:
Someone You Loved - Lewis Capaldi
Truth Hurts - LIZZO
Señorita - Shawn Mendes Feat. Camila Cabello
Only Human - Jonas Brothers
Circles - Post Malone
Goodbyes - Post Malone
Beautiful People - Ed Sheeran (feat. Khalid)
I Don't Care - Ed Sheeran & Justin Bieber
Trampoline - SHAED
bad guy - Billie Eilish
How Do You Sleep? - Sam Smith
Good As Hell - LIZZO
Time - NF
Motivation - Normani
Talk - Khalid

2009:
Fireflies - Owl City
Whatcha Say - Jason DeRulo
Down - Jay Sean (feat Lil Wayne)
Party in the U.S.A - Miley Cyrus
Run This Town –Jay-Z, Rihanna & Kanye West
Paparazzi - Lady Gaga
Meet Me Halfway - the Black Eyed Peas
3 - Britney Spears
I Gotta Feeling - the Black Eyed Peas
Sweet Dreams - Beyonce
You Belong With Me - Taylor Swift
Replay - Iyaz
Empire State Of Mind - Jay-Z & Alicia Keys
Forever - Drake (feat Kanye West, Lil Wayne, & Eminem)
Use Somebody - Kings of Leon

1999:
Smooth - Santana (feat Rob Thomas)
Satisfy You - Puff Daddy (featuring R. Kelly)
Heartbreaker - Mariah Carey (feat Jay-Z)
Mambo No. 5 (A little bit of ...) - Lou Bega
Unpretty - TLC
I Need To Know - Marc Anthony
My Love Is Your Love - Whitney Houston
Back At One - Brian McKnight
We Can't Be Friends - Deborah Cox & R.L.
Steal My Sunshine - Len
Someday - Sugar Ray
Scar Tissue - Red Hot Chili Peppers
Music of My Heart - 'N Sync & Gloria Estefan
(You Drive Me) Crazy - Britney Spears
Genie In A Bottle - Christina Aguilera
